12 11
3 3 3 3 3 3 3 3 3 3 3
3 0 0 0 0 0 0 0 0 0 3
3 0 0 1 0 0 0 0 0 0 3
3 0 0 0 3 0 3 3 0 0 3
3 0 0 2 3 0 0 0 0 0 3
3 0 0 0 3 3 0 0 3 0 3
3 0 0 0 0 3 3 0 0 0 3
3 0 0 0 3 3 3 3 0 0 3
3 3 0 0 0 0 4 0 0 0 3
3 3 0 0 0 0 0 0 0 3 3
3 3 3 0 3 0 0 0 3 3 3
3 3 3 3 3 3 3 3 3 3 3
5 8
3 3 3 3 3 3 3 3
3 0 2 0 3 0 1 3
3 0 0 3 3 0 0 3
3 0 4 0 0 0 4 3
3 3 3 3 3 3 3 3
6 5
3 3 3 3 3
3 0 1 3 3
3 0 2 0 3
3 3 0 0 3
3 0 4 0 3
3 3 3 3 3
5 5
3 3 3 3 3
3 3 1 3 3
3 4 0 4 3
3 3 2 3 3
3 3 3 3 3
3 5
3 3 3 3 3
3 1 2 4 3
3 3 3 3 3
7 10
3 3 3 3 3 3 3 3 3 3
3 0 0 0 0 0 4 0 0 3
3 0 1 0 0 0 0 0 0 3
3 0 3 3 3 0 0 2 0 3
3 0 0 0 4 0 0 0 0 3
3 0 0 0 0 0 0 0 0 3
3 3 3 3 3 3 3 3 3 3
