4 6
1 0 1 1 1 1
1 0 1 0 1 0
1 0 1 0 1 1
1 1 1 0 1 1
4 6
101111
101010
101011
111011
