8 6 5 4
0 0 0 0 0 0 
8 2 3 0 5 0
1 0 4 8 6 0 
1 0 7 1 0 0 
1 0 2 9 8 8 
1 0 5 7 4 3 
1 0 7 3 0 1
1 0 2 2 2 2 
